GSR	= "countries/GSR.txt"
PMN = "countries/PMN.txt"
RFE = "countries/RFE.txt"
RBA = "countries/RBA.txt"
RBB = "countries/RBB.txt"
RBD = "countries/RBD.txt"
CND = "countries/Canada.txt"
FSO = "countries/FSO.txt"
CGC = "countries/CGC - 坎加索.txt"
URA = "countries/URA - 美利坚邦联国.txt"
SCP = "countries/SCP - 西海岸共和国.txt"
ROT = "countries/ROT - 德克萨斯共和国.txt"
SUS = "countries/SUS - 迪克西国.txt"
ANT = "countries/ANT - 安第斯.txt"
ADS = "countries/ADS - 南美.txt"
GSK = "countries/GSK - 北高加索山区共和国.txt"
PAU = "countries/PAU - 乌克兰黑军（乌克兰革命起义军）.txt"
BPN = "countries/BPN - 黑人起义.txt"
LAP = "countries/LAP - 拉普拉塔先锋国.txt"
GLR = "countries/GLR - 德意志自由主义者起义.txt"
SSU = "countries/SSU - “国”（投机者联盟）.txt"
AIL = "countries/AIL - 拉丁解放军.txt"
CDF = "countries/CDF - 法兰西火十字团.txt"
FBN = "countries/FBN - 法兰西国民联盟.txt"
SIC = "countries/SIC - 川系军阀.txt"
YUE = "countries/YUE - 粤系军阀.txt"
SAR = "countries/SAR - 德兰士瓦.txt"
KER = "countries/KER - 康沃尔.txt"
NMK = "countries/NMK - 克拉科夫.txt"
AUR = "countries/AUR - 查谟和克什米尔.txt"
JUN = "countries/JUN - 朱纳格特.txt"